OXXXXXXXXXXXXXXXXXXXXXXXXXXXXXXXXXXXXXXXXXXXXXXXXXXXXXXXXXXXXXXXXXXXXX{
D.....................................................................A
D.....................................................................A
D.....................................................................A
D.....................................................................A
D.....................................................................A
D.....................................................................A
D.....................................................................A
D.....................................................................A
D.....................................................................A
D.....................................................................A
D.....................................................................A
D.....................................................................A
D.....................................................................A
D.....................................................................A
D...TGGGGGGGGGGGGGGGGGGGGGGGGGGGGGGGGGGGGGGGGGGGGGGGGGGGGGGGGGGGGGGGGG"
D.....................................................................A
D.....................................................................A
D.....................................................................A
D.....................................................................A
D.....................................................................A
D.......................................................YGB...........A
D.....................................................YG<.............A
D..........TGGGGGGGGGGB.............................YG<...............A
D.................................................YG<.................A
D...............................................TG<...................A
D.....................................................................A
D.......................TGGGGB..........TGGGGGB.......................A
D.....................................................................A
>WWWWWWWWWWWWWWWWWWWWWWWWWWWWWWWWWWWWWWWWWWWWWWWWWWWWWWWWWWWWWWWWWWWWW1
