#######################################################################
#.....................................................................#
#.....................................................................#
#.....................................................................#
#.....................................................................#
#.....................................................................#
#.....................................................................#
#.....................................................................#
#.....................................................................#
#.....................................................................#
#.....................................................................#
#.....................................................................#
#.....................................................................#
#.....................................................................#
#.....................................................................#
#.....................................................................#
#.....................................................................#
#.....................................................................#
#.....................................................................#
#.....................................................................#
#.....................................................................#
#.......................................................##............#
#.....................................................##..............#
#..........#############............................##................#
#.........#.......................................##..................#
#........#......................................##....................#
#.......#.............................................................#
#......#................######..........#######.......................#
#.....#...............................................................#
#######################################################################
