OXXXXXXXXXXXXXXXXXXXXXXXXXXXXXXXXXXXXXXXXXXXXXXXXXXXXXXXXXXXXXXXXXXXXX{
D.....................................................................A
D.....................................................................A
D.....................................................................A
D.....................................................................A
D.....................................................................A
D.....................................................................A
D.....................................................................A
D.....................................................................A
D.....................................................................A
D.....................................................................A
D.....................................................................A
D.....................................................................A
D.....................................................................A
D.....................................................................A
D...TGGGGGGGGGGGGGGGGGGGGGGGGGGGGGGGGGGGGGGGGGGGGGGGGGGGGGGGGGGGGGGGGG"
D.....................................................................A
D.....................................................................A
D.....................................................................A
D.....................................................................A
D.....................................................................A
D.....................................................................A
D..............................................................YGGGGGG"
D..........TGGGGGGGGGGB...................................YGGGG<......A
D....................................................YGGGG<...........A
D...............................................TGGGG<................A
D.....................................................................A
D.......................TGGGGB..........TGGGGGB.......................A
D.....................................................................A
>WWWWWWWWWWWWWWWWWWWWWWWWWWWWWWWWWWWWWWWWWWWWWWWWWWWWWWWWWWWWWWWWWWWWW1
